+---------------------+---------------------------+---------------------------+
|                     |                           |                           |
|                     |                           |                           |
|                     |                           |                           |
|                     |                           |                           |
|                     |                     +     +        +                  |
|          +-----+----+      +---+          |              |                  |
|                |               |          |              +----------+       |
|                |               |          |              |                  |
|                |               |          |              |                  |
|                |               |          |              |                  |
|                |               |          |              |      +-----------+
|                |               |          |              |                  |
|--------+       +      +--------+          +--------------+                  |
|                                                          |                  |
|                                                          |                  |
|-------------------------------+--------------------------+                  |
|                               |                                             | 
|                               |                                             |
|                               |                                             |
|              +-------+        |        +------------------------------------|
|              |                |                                             |
|       +------+                +                                             |
|              |                                                              |
|              |                                                    +---------|
|              +------------------+------------------+              |         |
|                                 |                                 |         |
|                                 |                                 |         |
+----------------------+          |         +-----------------------+         |
|                      |          +                                           |
|     @                +                                                      |
|                                                                             |
+-----------------------------------------------------------------------------+ 
*****